# Declare country tags expample:
DEB = "countries/Debugnation.txt"
BLK = "countries/Belka.txt"
OSF = "countries/Osea.txt"
UST = "countries/Ustio.txt"
RTA = "countries/Recta.txt"
GEB = "countries/Gebet.txt"
FAT = "countries/FATO.txt"
RTO = "countries/Ratio.txt"
SAP = "countries/Sapin.txt"
WVK = "countries/Wielvakia.txt"
NRL = "countries/Nordlands.txt"
WEL = "countries/Wellow.txt"
ERU = "countries/Erusea.txt"
YUK = "countries/Yuktobania.txt"
VER = "countries/Verusa.txt"
CLV = "countries/Clavis.txt"
 NRP = "countries/North Point.txt"
 SAN = "countries/San Salvacion.txt"
 AMB = "countries/Amber.txt"
 UGL = "countries/Ugellas.txt"
 DEL = "countries/Delarus.txt"
 FCU = "countries/FCU.txt"
 AUR = "countries/Aurelia.txt"
 LEA = "countries/Leasath.txt"
 PRB = "countries/Perbla.txt"
 SOT = "countries/Sotoa.txt"
 EMM = "countries/Emmeria.txt" 
 ESV = "countries/Estovakia.txt"
NRC = "countries/Nordennavic.txt"
BUL = "countries/Bulgudarest"
TST = "countries/Test.txt"